"filename", "language", "Python", "Markdown", "Shell Script", "Batch", "pip requirements", "comment", "blank", "total"
"/Users/yanghaozhe/Documents/Python/lumo/FCDataset.md", "Markdown", 0, 41, 0, 0, 0, 0, 15, 56
"/Users/yanghaozhe/Documents/Python/lumo/README.en.md", "Markdown", 0, 99, 0, 0, 0, 0, 63, 162
"/Users/yanghaozhe/Documents/Python/lumo/README.md", "Markdown", 0, 44, 0, 0, 0, 0, 30, 74
"/Users/yanghaozhe/Documents/Python/lumo/examples/1.trainer.py", "Python", 70, 0, 0, 0, 0, 138, 28, 236
"/Users/yanghaozhe/Documents/Python/lumo/examples/2.meters.py", "Python", 43, 0, 0, 0, 0, 4, 10, 57
"/Users/yanghaozhe/Documents/Python/lumo/examples/3.logger.py", "Python", 19, 0, 0, 0, 0, 3, 7, 29
"/Users/yanghaozhe/Documents/Python/lumo/examples/4.rnd_seed.py", "Python", 24, 0, 0, 0, 0, 5, 9, 38
"/Users/yanghaozhe/Documents/Python/lumo/examples/5.saver.py", "Python", 14, 0, 0, 0, 0, 1, 6, 21
"/Users/yanghaozhe/Documents/Python/lumo/examples/6.global_config.py", "Python", 10, 0, 0, 0, 0, 3, 4, 17
"/Users/yanghaozhe/Documents/Python/lumo/examples/7.exp.py", "Python", 27, 0, 0, 0, 0, 3, 13, 43
"/Users/yanghaozhe/Documents/Python/lumo/examples/8.params.py", "Python", 47, 0, 0, 0, 0, 6, 23, 76
"/Users/yanghaozhe/Documents/Python/lumo/examples/README.md", "Markdown", 0, 28, 0, 0, 0, 0, 12, 40
"/Users/yanghaozhe/Documents/Python/lumo/examples/benchmark/cifar-lumo.py", "Python", 83, 0, 0, 0, 0, 3, 30, 116
"/Users/yanghaozhe/Documents/Python/lumo/examples/benchmark/cifar-raw.py", "Python", 320, 0, 0, 0, 0, 39, 70, 429
"/Users/yanghaozhe/Documents/Python/lumo/examples/benchmark/lastcmd.sh", "Shell Script", 0, 0, 1, 0, 0, 0, 0, 1
"/Users/yanghaozhe/Documents/Python/lumo/examples/data/collate_fn_in_nlp.py", "Python", 34, 0, 0, 0, 0, 0, 14, 48
"/Users/yanghaozhe/Documents/Python/lumo/examples/data/dataloader_side.py", "Python", 34, 0, 0, 0, 0, 3, 7, 44
"/Users/yanghaozhe/Documents/Python/lumo/examples/data/datamodule.py", "Python", 31, 0, 0, 0, 0, 0, 5, 36
"/Users/yanghaozhe/Documents/Python/lumo/examples/data/nest_datasets.py", "Python", 32, 0, 0, 0, 0, 2, 9, 43
"/Users/yanghaozhe/Documents/Python/lumo/examples/data/quick_start.py", "Python", 40, 0, 0, 0, 0, 9, 10, 59
"/Users/yanghaozhe/Documents/Python/lumo/examples/experiment/quick_start.py", "Python", 6, 0, 0, 0, 0, 0, 1, 7
"/Users/yanghaozhe/Documents/Python/lumo/examples/lastcmd.sh", "Shell Script", 0, 0, 1, 0, 0, 0, 0, 1
"/Users/yanghaozhe/Documents/Python/lumo/examples/meter/quick_start.py", "Python", 14, 0, 0, 0, 0, 0, 5, 19
"/Users/yanghaozhe/Documents/Python/lumo/examples/more/attr.py", "Python", 6, 0, 0, 0, 0, 6, 6, 18
"/Users/yanghaozhe/Documents/Python/lumo/examples/more/avg_item.py", "Python", 5, 0, 0, 0, 0, 3, 5, 13
"/Users/yanghaozhe/Documents/Python/lumo/examples/more/global_var.py", "Python", 4, 0, 0, 0, 0, 6, 6, 16
"/Users/yanghaozhe/Documents/Python/lumo/examples/more/hook.py", "Python", 21, 0, 0, 0, 0, 5, 7, 33
"/Users/yanghaozhe/Documents/Python/lumo/examples/more/hpparamexp.py", "Python", 36, 0, 0, 0, 0, 51, 13, 100
"/Users/yanghaozhe/Documents/Python/lumo/examples/more/iter2obj.py", "Python", 0, 0, 0, 0, 0, 3, 2, 5
"/Users/yanghaozhe/Documents/Python/lumo/examples/more/markdownwrite.py", "Python", 13, 0, 0, 0, 0, 6, 5, 24
"/Users/yanghaozhe/Documents/Python/lumo/examples/more/mem.py", "Python", 0, 0, 0, 0, 0, 3, 3, 6
"/Users/yanghaozhe/Documents/Python/lumo/examples/more/none_item.py", "Python", 13, 0, 0, 0, 0, 3, 4, 20
"/Users/yanghaozhe/Documents/Python/lumo/examples/more/rampup.py", "Python", 0, 0, 0, 0, 0, 3, 3, 6
"/Users/yanghaozhe/Documents/Python/lumo/examples/more/schedules.py", "Python", 0, 0, 0, 0, 0, 0, 1, 1
"/Users/yanghaozhe/Documents/Python/lumo/examples/more/screen_str.py", "Python", 13, 0, 0, 0, 0, 3, 5, 21
"/Users/yanghaozhe/Documents/Python/lumo/examples/more/ssl.py", "Python", 5, 0, 0, 0, 0, 3, 6, 14
"/Users/yanghaozhe/Documents/Python/lumo/examples/more/temp.py", "Python", 10, 0, 0, 0, 0, 5, 4, 19
"/Users/yanghaozhe/Documents/Python/lumo/examples/more/timeit.py", "Python", 10, 0, 0, 0, 0, 3, 5, 18
"/Users/yanghaozhe/Documents/Python/lumo/examples/params/constrain.py", "Python", 11, 0, 0, 0, 0, 4, 6, 21
"/Users/yanghaozhe/Documents/Python/lumo/examples/params/extends.py", "Python", 25, 0, 0, 0, 0, 1, 8, 34
"/Users/yanghaozhe/Documents/Python/lumo/examples/params/quick_start.py", "Python", 11, 0, 0, 0, 0, 4, 6, 21
"/Users/yanghaozhe/Documents/Python/lumo/examples/quick_start.py", "Python", 47, 0, 0, 0, 0, 0, 15, 62
"/Users/yanghaozhe/Documents/Python/lumo/examples/run_1.trainer.py.sh", "Shell Script", 0, 0, 1, 0, 0, 4, 1, 6
"/Users/yanghaozhe/Documents/Python/lumo/examples/trainer/quick_start.py", "Python", 60, 0, 0, 0, 0, 11, 28, 99
"/Users/yanghaozhe/Documents/Python/lumo/examples/trainer/run_callbacks.py.sh", "Shell Script", 0, 0, 1, 0, 0, 1, 1, 3
"/Users/yanghaozhe/Documents/Python/lumo/examples/trainer/use_datamodule.py", "Python", 76, 0, 0, 0, 0, 15, 33, 124
"/Users/yanghaozhe/Documents/Python/lumo/install.py", "Python", 6, 0, 0, 0, 0, 1, 6, 13
"/Users/yanghaozhe/Documents/Python/lumo/lastcmd.sh", "Shell Script", 0, 0, 1, 0, 0, 0, 0, 1
"/Users/yanghaozhe/Documents/Python/lumo/publish.cmd", "Batch", 0, 0, 0, 1, 0, 0, 0, 1
"/Users/yanghaozhe/Documents/Python/lumo/requirements.txt", "pip requirements", 0, 0, 0, 0, 13, 0, 0, 13
"/Users/yanghaozhe/Documents/Python/lumo/setup.py", "Python", 29, 0, 0, 0, 0, 9, 5, 43
"/Users/yanghaozhe/Documents/Python/lumo/src/lumo/__init__.py", "Python", 6, 0, 0, 0, 0, 3, 2, 11
"/Users/yanghaozhe/Documents/Python/lumo/src/lumo/cli/__init__.py", "Python", 0, 0, 0, 0, 0, 4, 2, 6
"/Users/yanghaozhe/Documents/Python/lumo/src/lumo/cli/cli.py", "Python", 25, 0, 0, 0, 0, 55, 10, 90
"/Users/yanghaozhe/Documents/Python/lumo/src/lumo/cli/functional/__init__.py", "Python", 3, 0, 0, 0, 0, 0, 2, 5
"/Users/yanghaozhe/Documents/Python/lumo/src/lumo/cli/functional/clone.py", "Python", 21, 0, 0, 0, 0, 0, 10, 31
"/Users/yanghaozhe/Documents/Python/lumo/src/lumo/cli/functional/extract.py", "Python", 28, 0, 0, 0, 0, 0, 7, 35
"/Users/yanghaozhe/Documents/Python/lumo/src/lumo/cli/functional/init.py", "Python", 60, 0, 0, 0, 0, 0, 9, 69
"/Users/yanghaozhe/Documents/Python/lumo/src/lumo/cli/functional/lists.py", "Python", 0, 0, 0, 0, 0, 0, 1, 1
"/Users/yanghaozhe/Documents/Python/lumo/src/lumo/cli/functional/summary.py", "Python", 0, 0, 0, 0, 0, 0, 4, 4
"/Users/yanghaozhe/Documents/Python/lumo/src/lumo/cli/functional/tune.py", "Python", 0, 0, 0, 0, 0, 0, 1, 1
"/Users/yanghaozhe/Documents/Python/lumo/src/lumo/cli/functional/watch.py", "Python", 0, 0, 0, 0, 0, 0, 1, 1
"/Users/yanghaozhe/Documents/Python/lumo/src/lumo/contrib/__init__.py", "Python", 2, 0, 0, 0, 0, 3, 1, 6
"/Users/yanghaozhe/Documents/Python/lumo/src/lumo/contrib/board/BatchEmbedding.py", "Python", 19, 0, 0, 0, 0, 4, 7, 30
"/Users/yanghaozhe/Documents/Python/lumo/src/lumo/contrib/board/__init__.py", "Python", 0, 0, 0, 0, 0, 3, 2, 5
"/Users/yanghaozhe/Documents/Python/lumo/src/lumo/contrib/data/__init__.py", "Python", 1, 0, 0, 0, 0, 3, 2, 6
"/Users/yanghaozhe/Documents/Python/lumo/src/lumo/contrib/data/augments/__init__.py", "Python", 0, 0, 0, 0, 0, 0, 1, 1
"/Users/yanghaozhe/Documents/Python/lumo/src/lumo/contrib/data/augments/mix.py", "Python", 27, 0, 0, 0, 0, 8, 7, 42
"/Users/yanghaozhe/Documents/Python/lumo/src/lumo/contrib/data/augments/transforms.py", "Python", 14, 0, 0, 0, 0, 7, 4, 25
"/Users/yanghaozhe/Documents/Python/lumo/src/lumo/contrib/data/splits.py", "Python", 65, 0, 0, 0, 0, 36, 21, 122
"/Users/yanghaozhe/Documents/Python/lumo/src/lumo/contrib/itertools.py", "Python", 103, 0, 0, 0, 0, 52, 29, 184
"/Users/yanghaozhe/Documents/Python/lumo/src/lumo/contrib/module/__init__.py", "Python", 0, 0, 0, 0, 0, 0, 1, 1
"/Users/yanghaozhe/Documents/Python/lumo/src/lumo/contrib/module/ema.py", "Python", 37, 0, 0, 0, 0, 24, 19, 80
"/Users/yanghaozhe/Documents/Python/lumo/src/lumo/contrib/nn/__init__.py", "Python", 0, 0, 0, 0, 0, 0, 1, 1
"/Users/yanghaozhe/Documents/Python/lumo/src/lumo/contrib/nn/functional.py", "Python", 48, 0, 0, 0, 0, 58, 22, 128
"/Users/yanghaozhe/Documents/Python/lumo/src/lumo/contrib/nn/loss.py", "Python", 114, 0, 0, 0, 0, 101, 36, 251
"/Users/yanghaozhe/Documents/Python/lumo/src/lumo/contrib/nn/optimizer_builder.py", "Python", 0, 0, 0, 0, 0, 0, 1, 1
"/Users/yanghaozhe/Documents/Python/lumo/src/lumo/contrib/optim/__init__.py", "Python", 0, 0, 0, 0, 0, 16, 3, 19
"/Users/yanghaozhe/Documents/Python/lumo/src/lumo/contrib/optim/grouper.py", "Python", 46, 0, 0, 0, 0, 20, 15, 81
"/Users/yanghaozhe/Documents/Python/lumo/src/lumo/contrib/optim/lars.py", "Python", 82, 0, 0, 0, 0, 26, 36, 144
"/Users/yanghaozhe/Documents/Python/lumo/src/lumo/contrib/path.py", "Python", 16, 0, 0, 0, 0, 1, 6, 23
"/Users/yanghaozhe/Documents/Python/lumo/src/lumo/contrib/string/__init__.py", "Python", 1, 0, 0, 0, 0, 0, 1, 2
"/Users/yanghaozhe/Documents/Python/lumo/src/lumo/contrib/string/lcs.py", "Python", 142, 0, 0, 0, 0, 27, 26, 195
"/Users/yanghaozhe/Documents/Python/lumo/src/lumo/contrib/tb.py", "Python", 28, 0, 0, 0, 0, 0, 9, 37
"/Users/yanghaozhe/Documents/Python/lumo/src/lumo/contrib/torch/__init__.py", "Python", 0, 0, 0, 0, 0, 0, 1, 1
"/Users/yanghaozhe/Documents/Python/lumo/src/lumo/contrib/torch/accuracy.py", "Python", 16, 0, 0, 0, 0, 18, 6, 40
"/Users/yanghaozhe/Documents/Python/lumo/src/lumo/contrib/torch/memoty_bank.py", "Python", 39, 0, 0, 0, 0, 0, 16, 55
"/Users/yanghaozhe/Documents/Python/lumo/src/lumo/contrib/torch/tensor.py", "Python", 49, 0, 0, 0, 0, 130, 29, 208
"/Users/yanghaozhe/Documents/Python/lumo/src/lumo/contrib/transforms/__init__.py", "Python", 0, 0, 0, 0, 0, 0, 1, 1
"/Users/yanghaozhe/Documents/Python/lumo/src/lumo/contrib/transforms/transforms.py", "Python", 14, 0, 0, 0, 0, 7, 5, 26
"/Users/yanghaozhe/Documents/Python/lumo/src/lumo/core/README.md", "Markdown", 0, 9, 0, 0, 0, 0, 1, 10
"/Users/yanghaozhe/Documents/Python/lumo/src/lumo/core/__init__.py", "Python", 7, 0, 0, 0, 0, 0, 1, 8
"/Users/yanghaozhe/Documents/Python/lumo/src/lumo/core/attr.py", "Python", 38, 0, 0, 0, 0, 3, 12, 53
"/Users/yanghaozhe/Documents/Python/lumo/src/lumo/core/enums.py", "Python", 17, 0, 0, 0, 0, 0, 7, 24
"/Users/yanghaozhe/Documents/Python/lumo/src/lumo/core/interp.py", "Python", 270, 0, 0, 0, 0, 84, 96, 450
"/Users/yanghaozhe/Documents/Python/lumo/src/lumo/core/list.py", "Python", 31, 0, 0, 0, 0, 25, 8, 64
"/Users/yanghaozhe/Documents/Python/lumo/src/lumo/core/metaclasses.py", "Python", 59, 0, 0, 0, 0, 23, 27, 109
"/Users/yanghaozhe/Documents/Python/lumo/src/lumo/core/meter.py", "Python", 180, 0, 0, 0, 0, 10, 42, 232
"/Users/yanghaozhe/Documents/Python/lumo/src/lumo/core/params.py", "Python", 174, 0, 0, 0, 0, 76, 67, 317
"/Users/yanghaozhe/Documents/Python/lumo/src/lumo/core/raises.py", "Python", 2, 0, 0, 0, 0, 0, 3, 5
"/Users/yanghaozhe/Documents/Python/lumo/src/lumo/core/record.py", "Python", 89, 0, 0, 0, 0, 4, 26, 119
"/Users/yanghaozhe/Documents/Python/lumo/src/lumo/core/record_backend/__init__.py", "Python", 0, 0, 0, 0, 0, 0, 1, 1
"/Users/yanghaozhe/Documents/Python/lumo/src/lumo/core/record_backend/abc.py", "Python", 16, 0, 0, 0, 0, 0, 5, 21
"/Users/yanghaozhe/Documents/Python/lumo/src/lumo/core/record_backend/record_csv.py", "Python", 0, 0, 0, 0, 0, 0, 1, 1
"/Users/yanghaozhe/Documents/Python/lumo/src/lumo/core/record_backend/record_sqlite.py", "Python", 0, 0, 0, 0, 0, 0, 1, 1
"/Users/yanghaozhe/Documents/Python/lumo/src/lumo/core/record_backend/record_tb.py", "Python", 0, 0, 0, 0, 0, 0, 1, 1
"/Users/yanghaozhe/Documents/Python/lumo/src/lumo/core/record_backend/record_wandb.py", "Python", 2, 0, 0, 0, 0, 0, 1, 3
"/Users/yanghaozhe/Documents/Python/lumo/src/lumo/core/tree.py", "Python", 89, 0, 0, 0, 0, 4, 28, 121
"/Users/yanghaozhe/Documents/Python/lumo/src/lumo/data/README.md", "Markdown", 0, 4, 0, 0, 0, 0, 1, 5
"/Users/yanghaozhe/Documents/Python/lumo/src/lumo/data/__init__.py", "Python", 4, 0, 0, 0, 0, 0, 1, 5
"/Users/yanghaozhe/Documents/Python/lumo/src/lumo/data/__main__.py", "Python", 0, 0, 0, 0, 0, 15, 1, 16
"/Users/yanghaozhe/Documents/Python/lumo/src/lumo/data/accelerator.py", "Python", 109, 0, 0, 0, 0, 60, 21, 190
"/Users/yanghaozhe/Documents/Python/lumo/src/lumo/data/builder.py", "Python", 224, 0, 0, 0, 0, 10, 65, 299
"/Users/yanghaozhe/Documents/Python/lumo/src/lumo/data/collate.py", "Python", 77, 0, 0, 0, 0, 4, 22, 103
"/Users/yanghaozhe/Documents/Python/lumo/src/lumo/data/datamodule.py", "Python", 33, 0, 0, 0, 0, 0, 13, 46
"/Users/yanghaozhe/Documents/Python/lumo/src/lumo/data/loader.py", "Python", 119, 0, 0, 0, 0, 15, 33, 167
"/Users/yanghaozhe/Documents/Python/lumo/src/lumo/decorators/__init__.py", "Python", 4, 0, 0, 0, 0, 0, 1, 5
"/Users/yanghaozhe/Documents/Python/lumo/src/lumo/decorators/clsmethod.py", "Python", 7, 0, 0, 0, 0, 9, 6, 22
"/Users/yanghaozhe/Documents/Python/lumo/src/lumo/decorators/deprecated.py", "Python", 116, 0, 0, 0, 0, 132, 44, 292
"/Users/yanghaozhe/Documents/Python/lumo/src/lumo/decorators/lazy_required.py", "Python", 29, 0, 0, 0, 0, 1, 12, 42
"/Users/yanghaozhe/Documents/Python/lumo/src/lumo/decorators/map_extract.py", "Python", 16, 0, 0, 0, 0, 0, 3, 19
"/Users/yanghaozhe/Documents/Python/lumo/src/lumo/decorators/process.py", "Python", 7, 0, 0, 0, 0, 0, 5, 12
"/Users/yanghaozhe/Documents/Python/lumo/src/lumo/decorators/regist.py", "Python", 34, 0, 0, 0, 0, 0, 12, 46
"/Users/yanghaozhe/Documents/Python/lumo/src/lumo/exp/README.md", "Markdown", 0, 10, 0, 0, 0, 0, 4, 14
"/Users/yanghaozhe/Documents/Python/lumo/src/lumo/exp/__init__.py", "Python", 1, 0, 0, 0, 0, 0, 1, 2
"/Users/yanghaozhe/Documents/Python/lumo/src/lumo/exp/__main__.py", "Python", 0, 0, 0, 0, 0, 3, 1, 4
"/Users/yanghaozhe/Documents/Python/lumo/src/lumo/exp/agent.py", "Python", 23, 0, 0, 0, 0, 3, 11, 37
"/Users/yanghaozhe/Documents/Python/lumo/src/lumo/exp/experiment.py", "Python", 270, 0, 0, 0, 0, 41, 60, 371
"/Users/yanghaozhe/Documents/Python/lumo/src/lumo/exp/exphook.py", "Python", 136, 0, 0, 0, 0, 3, 42, 181
"/Users/yanghaozhe/Documents/Python/lumo/src/lumo/exp/finder.py", "Python", 74, 0, 0, 0, 0, 0, 25, 99
"/Users/yanghaozhe/Documents/Python/lumo/src/lumo/lazy/__init__.py", "Python", 0, 0, 0, 0, 0, 0, 1, 1
"/Users/yanghaozhe/Documents/Python/lumo/src/lumo/nest/__init__.py", "Python", 0, 0, 0, 0, 0, 0, 1, 1
"/Users/yanghaozhe/Documents/Python/lumo/src/lumo/nest/trainer/__init__.py", "Python", 0, 0, 0, 0, 0, 3, 0, 3
"/Users/yanghaozhe/Documents/Python/lumo/src/lumo/nest/trainer/acc.py", "Python", 71, 0, 0, 0, 0, 26, 20, 117
"/Users/yanghaozhe/Documents/Python/lumo/src/lumo/nest/trainer/callbacks.py", "Python", 11, 0, 0, 0, 0, 0, 4, 15
"/Users/yanghaozhe/Documents/Python/lumo/src/lumo/nest/trainer/losses.py", "Python", 105, 0, 0, 0, 0, 42, 38, 185
"/Users/yanghaozhe/Documents/Python/lumo/src/lumo/proc/__init__.py", "Python", 1, 0, 0, 0, 0, 3, 1, 5
"/Users/yanghaozhe/Documents/Python/lumo/src/lumo/proc/date.py", "Python", 18, 0, 0, 0, 0, 16, 12, 46
"/Users/yanghaozhe/Documents/Python/lumo/src/lumo/proc/dependency.py", "Python", 19, 0, 0, 0, 0, 1, 9, 29
"/Users/yanghaozhe/Documents/Python/lumo/src/lumo/proc/dist.py", "Python", 18, 0, 0, 0, 0, 0, 11, 29
"/Users/yanghaozhe/Documents/Python/lumo/src/lumo/proc/network.py", "Python", 8, 0, 0, 0, 0, 5, 1, 14
"/Users/yanghaozhe/Documents/Python/lumo/src/lumo/proc/path.py", "Python", 58, 0, 0, 0, 0, 0, 23, 81
"/Users/yanghaozhe/Documents/Python/lumo/src/lumo/server/__init__.py", "Python", 0, 0, 0, 0, 0, 0, 1, 1
"/Users/yanghaozhe/Documents/Python/lumo/src/lumo/server/__main__.py", "Python", 0, 0, 0, 0, 0, 0, 1, 1
"/Users/yanghaozhe/Documents/Python/lumo/src/lumo/server/apis/__init__.py", "Python", 0, 0, 0, 0, 0, 0, 1, 1
"/Users/yanghaozhe/Documents/Python/lumo/src/lumo/sketch/__init__.py", "Python", 0, 0, 0, 0, 0, 7, 2, 9
"/Users/yanghaozhe/Documents/Python/lumo/src/lumo/sketch/audio/README.md", "Markdown", 0, 1, 0, 0, 0, 0, 1, 2
"/Users/yanghaozhe/Documents/Python/lumo/src/lumo/sketch/audio/__init__.py", "Python", 0, 0, 0, 0, 0, 0, 1, 1
"/Users/yanghaozhe/Documents/Python/lumo/src/lumo/sketch/audio/audio_tools.py", "Python", 34, 0, 0, 0, 0, 13, 11, 58
"/Users/yanghaozhe/Documents/Python/lumo/src/lumo/sketch/audio/unsupervised_vad.py", "Python", 71, 0, 0, 0, 0, 39, 27, 137
"/Users/yanghaozhe/Documents/Python/lumo/src/lumo/sketch/cudamemory.py", "Python", 5, 0, 0, 0, 0, 0, 2, 7
"/Users/yanghaozhe/Documents/Python/lumo/src/lumo/sketch/filelock.py", "Python", 28, 0, 0, 0, 0, 0, 16, 44
"/Users/yanghaozhe/Documents/Python/lumo/src/lumo/sketch/finder.py", "Python", 0, 0, 0, 0, 0, 447, 2, 449
"/Users/yanghaozhe/Documents/Python/lumo/src/lumo/sketch/memory_grab.py", "Python", 185, 0, 0, 0, 0, 47, 43, 275
"/Users/yanghaozhe/Documents/Python/lumo/src/lumo/sketch/nddatasets/__init__.py", "Python", 0, 0, 0, 0, 0, 3, 2, 5
"/Users/yanghaozhe/Documents/Python/lumo/src/lumo/sketch/nddatasets/ndtransforms.py", "Python", 74, 0, 0, 0, 0, 8, 27, 109
"/Users/yanghaozhe/Documents/Python/lumo/src/lumo/sketch/nddatasets/pttransforms.py", "Python", 30, 0, 0, 0, 0, 7, 15, 52
"/Users/yanghaozhe/Documents/Python/lumo/src/lumo/sketch/objectdetect.py", "Python", 52, 0, 0, 0, 0, 18, 14, 84
"/Users/yanghaozhe/Documents/Python/lumo/src/lumo/sketch/parallel_coor.py", "Python", 49, 0, 0, 0, 0, 6, 8, 63
"/Users/yanghaozhe/Documents/Python/lumo/src/lumo/sketch/preprocess_mean_std.py", "Python", 33, 0, 0, 0, 0, 2, 11, 46
"/Users/yanghaozhe/Documents/Python/lumo/src/lumo/sketch/randaugment.py", "Python", 158, 0, 0, 0, 0, 8, 54, 220
"/Users/yanghaozhe/Documents/Python/lumo/src/lumo/sketch/tensorboard_event.py", "Python", 35, 0, 0, 0, 0, 1, 10, 46
"/Users/yanghaozhe/Documents/Python/lumo/src/lumo/sketch/torchsummary.py", "Python", 89, 0, 0, 0, 0, 11, 22, 122
"/Users/yanghaozhe/Documents/Python/lumo/src/lumo/sketch/vis.py", "Python", 30, 0, 0, 0, 0, 0, 10, 40
"/Users/yanghaozhe/Documents/Python/lumo/src/lumo/trainer/__init__.py", "Python", 4, 0, 0, 0, 0, 0, 1, 5
"/Users/yanghaozhe/Documents/Python/lumo/src/lumo/trainer/accelerator.py", "Python", 78, 0, 0, 0, 0, 31, 18, 127
"/Users/yanghaozhe/Documents/Python/lumo/src/lumo/trainer/base.py", "Python", 146, 0, 0, 0, 0, 48, 42, 236
"/Users/yanghaozhe/Documents/Python/lumo/src/lumo/trainer/callbacks.py", "Python", 713, 0, 0, 0, 0, 115, 215, 1043
"/Users/yanghaozhe/Documents/Python/lumo/src/lumo/trainer/components.py", "Python", 75, 0, 0, 0, 0, 0, 19, 94
"/Users/yanghaozhe/Documents/Python/lumo/src/lumo/trainer/factory.py", "Python", 81, 0, 0, 0, 0, 0, 26, 107
"/Users/yanghaozhe/Documents/Python/lumo/src/lumo/trainer/rnd.py", "Python", 51, 0, 0, 0, 0, 25, 16, 92
"/Users/yanghaozhe/Documents/Python/lumo/src/lumo/trainer/saver.py", "Python", 166, 0, 0, 0, 0, 91, 32, 289
"/Users/yanghaozhe/Documents/Python/lumo/src/lumo/trainer/trainer.py", "Python", 451, 0, 0, 0, 0, 58, 112, 621
"/Users/yanghaozhe/Documents/Python/lumo/src/lumo/utils/__init__.py", "Python", 5, 0, 0, 0, 0, 0, 2, 7
"/Users/yanghaozhe/Documents/Python/lumo/src/lumo/utils/exithook.py", "Python", 22, 0, 0, 0, 0, 3, 13, 38
"/Users/yanghaozhe/Documents/Python/lumo/src/lumo/utils/fmt.py", "Python", 35, 0, 0, 0, 0, 1, 21, 57
"/Users/yanghaozhe/Documents/Python/lumo/src/lumo/utils/logger.py", "Python", 209, 0, 0, 0, 0, 20, 56, 285
"/Users/yanghaozhe/Documents/Python/lumo/src/lumo/utils/random.py", "Python", 41, 0, 0, 0, 0, 23, 14, 78
"/Users/yanghaozhe/Documents/Python/lumo/src/lumo/utils/repository.py", "Python", 120, 0, 0, 0, 0, 81, 45, 246
"/Users/yanghaozhe/Documents/Python/lumo/src/lumo/utils/safe_io.py", "Python", 78, 0, 0, 0, 0, 5, 27, 110
"/Users/yanghaozhe/Documents/Python/lumo/src/lumo/utils/screen.py", "Python", 116, 0, 0, 0, 0, 14, 38, 168
"/Users/yanghaozhe/Documents/Python/lumo/src/lumo/utils/timer.py", "Python", 71, 0, 0, 0, 0, 18, 24, 113
"/Users/yanghaozhe/Documents/Python/lumo/src/lumo/vis/__init__.py", "Python", 0, 0, 0, 0, 0, 0, 1, 1
"/Users/yanghaozhe/Documents/Python/lumo/src/lumo/vis/__main__.py", "Python", 84, 0, 0, 0, 0, 9, 24, 117
"/Users/yanghaozhe/Documents/Python/lumo/src/lumo/vis/parser.py", "Python", 55, 0, 0, 0, 0, 0, 13, 68
"/Users/yanghaozhe/Documents/Python/lumo/src/lumo/vis/parser_tb.py", "Python", 41, 0, 0, 0, 0, 1, 12, 54
"/Users/yanghaozhe/Documents/Python/lumo/template/one-file.tmp.py", "Python", 66, 0, 0, 0, 0, 14, 38, 118
"/Users/yanghaozhe/Documents/Python/lumo/tests/base_classes/__init__.py", "Python", 0, 0, 0, 0, 0, 3, 2, 5
"/Users/yanghaozhe/Documents/Python/lumo/tests/base_classes/test_attr.py", "Python", 52, 0, 0, 0, 0, 0, 17, 69
"/Users/yanghaozhe/Documents/Python/lumo/tests/base_classes/test_list.py", "Python", 6, 0, 0, 0, 0, 0, 3, 9
"/Users/yanghaozhe/Documents/Python/lumo/tests/base_classes/test_meta_classes.py", "Python", 9, 0, 0, 0, 0, 3, 7, 19
"/Users/yanghaozhe/Documents/Python/lumo/tests/base_classes/test_tree.py", "Python", 7, 0, 0, 0, 0, 3, 4, 14
"/Users/yanghaozhe/Documents/Python/lumo/tests/base_classes/test_trick_item.py", "Python", 21, 0, 0, 0, 0, 3, 6, 30
"/Users/yanghaozhe/Documents/Python/lumo/tests/calculate/__init__.py", "Python", 0, 0, 0, 0, 0, 3, 2, 5
"/Users/yanghaozhe/Documents/Python/lumo/tests/calculate/test_acc.py", "Python", 8, 0, 0, 0, 0, 3, 5, 16
"/Users/yanghaozhe/Documents/Python/lumo/tests/contrib/__init__.py", "Python", 0, 0, 0, 0, 0, 0, 1, 1
"/Users/yanghaozhe/Documents/Python/lumo/tests/contrib/test_functional.py", "Python", 155, 0, 0, 0, 0, 24, 43, 222
"/Users/yanghaozhe/Documents/Python/lumo/tests/contrib/test_module.py", "Python", 0, 0, 0, 0, 0, 0, 1, 1
"/Users/yanghaozhe/Documents/Python/lumo/tests/contrib/test_pickle.py", "Python", 0, 0, 0, 0, 0, 0, 1, 1
"/Users/yanghaozhe/Documents/Python/lumo/tests/contrib/test_string.py", "Python", 15, 0, 0, 0, 0, 0, 3, 18
"/Users/yanghaozhe/Documents/Python/lumo/tests/kit/__init__.py", "Python", 0, 0, 0, 0, 0, 0, 1, 1
"/Users/yanghaozhe/Documents/Python/lumo/tests/kit/test_builder.py", "Python", 45, 0, 0, 0, 0, 1, 14, 60
"/Users/yanghaozhe/Documents/Python/lumo/tests/kit/test_callback.py", "Python", 86, 0, 0, 0, 0, 0, 46, 132
"/Users/yanghaozhe/Documents/Python/lumo/tests/kit/test_meter.py", "Python", 52, 0, 0, 0, 0, 1, 14, 67
"/Users/yanghaozhe/Documents/Python/lumo/tests/kit/test_rndmanager.py", "Python", 13, 0, 0, 0, 0, 0, 3, 16
"/Users/yanghaozhe/Documents/Python/lumo/tests/kit/test_saver.py", "Python", 29, 0, 0, 0, 0, 0, 10, 39
"/Users/yanghaozhe/Documents/Python/lumo/tests/test_interp.py", "Python", 10, 0, 0, 0, 0, 0, 6, 16
"/Users/yanghaozhe/Documents/Python/lumo/tests/test_lr_scheduler.py", "Python", 10, 0, 0, 0, 0, 0, 4, 14
"/Users/yanghaozhe/Documents/Python/lumo/tests/utils/__init__.py", "Python", 0, 0, 0, 0, 0, 3, 2, 5
"/Users/yanghaozhe/Documents/Python/lumo/tests/utils/test_random.py", "Python", 6, 0, 0, 0, 0, 3, 4, 13
"Total", "-", 8926, 236, 5, 1, 13, 2823, 3034, 15038